NO	textures/north.xpm
SO	textures/south.xpm
EA	textures/east.xpm
WE	textures/west.xpm

C	127,127,255
F	127,255,127

TP	95BTG

 111111111111111
1000T00000000001
1000000000000001                          111111
1000000100000001                          100T1
1000001 10000001                          11111
10000W01000000001
1000000000000001
1111111111111111
