NO	textures/north.xpm
SO	textures/south.xpm
EA	textures/east.xpm
WE	textures/west.xpm

C	127,127,255
F	127,255,127

11111111111111
10000000000001
1000000000N001
11111111111111
