NO	textures/north.xpm
SO	textures/south.xpm
EA	textures/east.xpm
WE	textures/west.xpm

C	127,127,255
F	127,255,127

11111111111111
1000000000000111111111111111111111111111111111111111111
1000000000000000000000000000000000000000000000000000001
1000000000000000000000000000000000000000000000000000001
1000000000010000000000000000000000000000000000000000001
1000000000000000000000000000000000000000000000000000001
1000000000000000000000000000000000000000000000000000001
1000000000000000000000000000000000000000000000000000001
1000000000000000000000000000000000000000000000000000001
1000000000000000000000000000000000000000000000000000001
1000000000000000000000000000E00000000000000000000000001
1000000000000000000000000000000000000000000000000000001
10000000000000000000000010000000000000000000000000000001
1000000111111000000000000000000000000000000000000000001
1000000000000000000000010000000000000000000000000000001
1000000000000000000000000000000000000000000000000000001
1000000000000000000000000000000000000000000000000000001
1000000000000000000010000000000000000000100010000000001
1000000000000000000000000000000000000000100000000000001
1000000000000000000000000000000000000000100000000000001
1000000000000000000000000000000000000000100000000000001
1000000000000000000000000000000000000000100000000000001
1000000000000000000000000000000000000000100000000000001
100100000000011111111111111111111111111111111111111111111
1111111111111111111111111
